// Level 03:

{
	"width": 10,
	"height": 14,
	"grid": [
		2, 8, 8, 8, 8, 8, 8, 8, 8, 2,
		7, 6, 2, 1, 7, 6, 2, 1, 6, 8,
		7, 8, 8, 8, 8, 8, 8, 8, 8, 7,
		1, 1, 7, 6, 2, 1, 7, 1, 6, 8,
		8, 8, 8, 8, 6, 8, 8, 8, 8, 8,
		8, 8, 8, 8, 2, 8, 8, 8, 8, 8,
		8, 8, 8, 8, 6, 8, 8, 8, 8, 8,
		8, 8, 8, 8, 8, 8, 8, 8, 8, 8,
		8, 8, 8, 8, 8, 8, 8, 8, 8, 8,
		8, 8, 8, 8, 8, 8, 8, 8, 8, 8,
		8, 8, 8, 8, 8, 8, 8, 8, 8, 8,
		8, 8, 8, 8, 8, 8, 8, 8, 8, 8,
		8, 8, 8, 8, 8, 8, 8, 8, 8, 8,
		8, 8, 8, 8, 8, 8, 8, 8, 8, 8
	]
}