// Level 06:

{
	"width": 10,
	"height": 14,
	"grid": [
		6, 7, 2, 1, 2, 3, 1, 5, 6, 7,
		1, 8, 1, 8, 3, 8, 7, 8, 1, 8,
		8, 3, 3, 5, 6, 6, 1, 3, 5, 8,
		8, 7, 8, 3, 8, 5, 8, 6, 8, 8,
		8, 7, 6, 3, 7, 2, 5, 1, 3, 8,
		3, 8, 6, 8, 6, 8, 1, 8, 3, 8,
		1, 2, 2, 3, 7, 5, 6, 6, 1, 2,
		8, 8, 8, 8, 8, 8, 8, 8, 8, 8,
		8, 8, 8, 8, 8, 8, 8, 8, 8, 8,
		8, 8, 8, 8, 8, 8, 8, 8, 8, 8,
		8, 8, 8, 8, 8, 8, 8, 8, 8, 8,
		8, 8, 8, 8, 8, 8, 8, 8, 8, 8,
		8, 8, 8, 8, 8, 8, 8, 8, 8, 8,
		8, 8, 8, 8, 8, 8, 8, 8, 8, 8
	]
}