// Level 08:

{
	"width": 10,
	"height": 14,
	"grid": [
		5, 3, 2, 6, 2, 1, 3, 7, 1, 2,
		2, 7, 7, 6, 3, 2, 5, 7, 3, 1,
		3, 5, 1, 7, 6, 6, 4, 2, 5, 2,
		4, 7, 6, 4, 2, 5, 1, 2, 6, 4,
		8, 8, 8, 8, 8, 8, 8, 8, 8, 8,
		8, 8, 8, 8, 8, 8, 8, 8, 8, 8,
		8, 8, 8, 8, 8, 8, 8, 8, 8, 8,
		8, 8, 8, 8, 8, 8, 8, 8, 8, 8,
		8, 8, 8, 8, 8, 8, 8, 8, 8, 8,
		8, 8, 8, 8, 8, 8, 8, 8, 8, 8,
		8, 8, 8, 8, 8, 8, 8, 8, 8, 8,
		8, 8, 8, 8, 8, 8, 8, 8, 8, 8,
		8, 8, 8, 8, 8, 8, 8, 8, 8, 8,
		8, 8, 8, 8, 8, 8, 8, 8, 8, 8
	]
}